10

,-

Alzsslv FOR ssO'l'ANlK. ΒΑΜ) 17. Nzo a.

Mahaut franc = Hebiscus tiliaceus.

Mn'is bonini = Dur-emta erecta.

Maman lamam = Phyealis turbinata.
Manmanhouano = Hypnia verticillata.
Max-guerite = Lippia spec. (ex E1<M.; non vidi).
Mama coli = Cereus triangularis.

Medecinier d’Indo = Jatropha multifida.

Os du rein = Hf'unffhmomzia Staminea.
Ouaehe-ouaehe = Illclanthera Buchii.
Palmiste ὲ, vin Ξ Calyptroyyne occidentalis.
Parietaire = Rousselia humilis.

Petit baume marron = Salvia occidentalis. Χ
Petit haume max-ron = Vernonia saepiam.
Petit bois blane = Schaejferia frutescens.
Petit bois d’Indo = Euqenia monticola.
Petit bon Dieu mori = Callisia repens.
Petites dentelles = Pilecz microphylla.
Petites feuilles = Euqenia buxisolia.

Petite liano Ibo = Echites repens.

Piquant radzi = Oasearfia aculeata.

Poirier = Erythroxylu‘m areolatum.

Pois deseonnu = Viyna simensis.

Pois inconnu = Viqna simensis.

Pomme torche = Cereus assuryens.

Queue do rat = Piper spec. diversae.
Quium-sous = Eriqeron spathulatus.

Raisin grandes feuilles = Coccoloba pube-scen&
Roi des bois = Phoradendron vel Dendrophthora spec. diversae.
Romarin = Croton linearis.

sagon marron = Canna coccinea.

Sapotillier marr-on = Dipholis salicisolia.
sifflet = Corchorus hirsutus.

Sirop = Sambucus canademis var. laciniatus.
Tchia-tohia = Albizzia Lebbeclo.

Tchiartehia marron = Leucaena alauca.

T6t6 jeune fille = solanum mammosum.
Toque molle = Passislora foetida.

Vaillant garqon = Pz'cramnia pentandra.

Zombi nan bois = Turnera ulmifolia var· intermedia.

k γ ,ἤηῗ ᾼᾷῗ -

Tryekt den 29 november 1921.

Uppsala 1921. A1mqvist ἅ Wiksells Bokt1·yekeri·A.—B.

