lGN. URBAN, PLANTAE HAITOENSES.

Chene capam} = Gordia alliodora.
Chic-chio = Allophylus riqidus.

Choux moutarde = Brassica inteqrifolia.
Choux rave = Brassica inteqrtsolia.

Cicrin = Inqa vera.

Citroin marton = Sarcomphalus dominyensz's.
Coeo maeaque = Cocothrinaoe εσορανῐα.
Collier = Pithecolobium arboreum.

Coma = Sideroxylon foetidissimum.

Corail = Olerodendron fallax.

Cordon = Crudia antidana.

Cetelette = Drypetes pirisormis.
Coulantre = Erynqium foetidum.

Couper colone = Borreria laevis.

Cresson danois = Lepzssdium viryinicum.
Damage = Calophyllum calaba.

Des dos Ξ Phyllanthus niruri.

Des gonfles = Acalypka alopecuroidea.
Dombou = Trichilia pallida.

Douleur = Morinda citrifolia.
Esearpilaire = Ceropteria calomelanoe.
Espagnol marron = Phyllanlhus qrandijolius.
Feuilles boundzi = Eupatorium macrophyllum.
Feuilles sirop = Piper marqinatum.
Figuier = Ficus mitrophora.

Galle-galle = Reynosia uncinata.

Gan-lain = Funastrum clausum.
Gati-galle = Picletia spinifolia.

Gayac femelle = Guaiacum sanctum.
Gayac male = Guajacum officinale.
Gazon = Paspalum fimbriatum.

Goavier = Guettarda Prenleloupiz'.

Griffe chat = Biqnonia unquis cati.
Gris-gris = Buche‘navia capitata.

Gris-gris = Rue-ida bucerus.

Gros jone mattae = Typha dominyemis.
Gros petites feuilles = Euqenia laevis.
Gui = Phoradendron vel Dendrophthora spec. diversae.
Heliotrope = Eichhornia crassipee.

Herbe quiquitte = Panicum fasciculatum.
Herbe rasoir = Gladium mariscus.

Herbe vetivert = Anatherum zizanioides.
Indigo = Indiyosera sussruticona.

Jasmin double = Jasminum Sambac.
Jeucon = Helicteres semitricoba.

Jone espagnol = Paspalum filisorme.
Jonc mahte = Heleocharis qeniculata.
Laibier· = cameraria latifolia.

Liane ὲ clou = Dalberqia Brownei.

Liane couleuvre = Paaeiflora rubra.
Liane erabe = Celtis iyuanea.

Liane gan lait, = Funastrum clausum
Liane mimebi blanche = combretum Jacquini.
Liano Os du rein = Wumchmanm'a flaminea.
Liane persil = Serjania polyphylla.

Liane ὲ, scie = Arundinaria haitienssz'e.
Liane violon = Centroeema virginianum.
Liane zor-ain = Wunschmannia staminea.
Lilas = Sozanum Seasorlhianum.

Macrioi = M iconia impetiolaris.

Mahaut = Pavom‘a opicata.

