70 Amssv Foss BOTANIK. BAND 17. Nto 7.

Nomina vernacula.

Ex adnotationibus cl. EKMANII, in Flora domingensi mea
nondum Commemorata.

Arbre-iz-pain marron = Bocconia srutescem.
Athmyo = Ocimum qralisszmum.

Avocat marron = Antirrhoea lucida.

Balai velour = Capparis ferruqinea.
Balanier marren = Heliconia bihai,
Bobelle (pro Belle-belle)= Gordia ensifolz'a.
Bois blane = Croton glabellus.

Bois blanc = Slmaruba officinalis.

Bois cabrit = Psychotria spec. div. floribus flavis.
Bois caca = Capparis cynophallophora.
Bois de coq = Hyperbaena Lindmanii.
Bois erapaud = Wallem'a laurifolia.

Bois douleur = Morinda citrifolia.

Bois espagnol = Oomocladia pinnatilolia.
Bois cle fer = Kruyiodendron ferreum.

Bois feuilles blanches = Celtis Berteroana et O, trinervz'a.
Bois de gusspe = Croton qlabellus.

Bois d’ine = Eugenia sraqrcms.

Bois de lance = Oxandra lanceolata.

Bois merise = Pseudolmedia spuria.

Bois nogre = Allophyllas riqidus.

Bois noir = Ocotea spec.

Bois d’ortie = Oarpodiptera cabensis.

Bois peIeS = colubrina ferruginosa.

Bois raide = Maba caribaea.

Bois de savanes = Tabebuz‘a Ekmanii.
Bois sentix· = Aleleia qummifera.

Bois sentit = Bunchosia media eb B. nitida.
Bois sirop = Piper maminotum.

Bois de soie = Trema micranthum.

Bois trembler = Didymopanaae tremulum.
Boniface = Eichhorm'a cras-eim&

Brosillet = ansalpinia barakonensis.
Brignole = Goeloneurum ferruqineum.
Canachi> = Capparis cynophallophora.
Caeorne marron = Grudia amillana. ⁷
Cafo mat-ron = Beureria succulenta.
Calebassio = Passillora malisormis.

Capar6 = Gordia alliodora.

Capitaine = Malpiqhia dominqensis.
Cara'ibe gratter = Synqonium auritum.
casse marron = Caenia emarqinata.
Chardon bonit = Arqemone mexicana.
Chone calebassic = Petilia dominqensis.

